//MAP CONVERTED BY dmm2tgm.py THIS HEADER COMMENT PREVENTS RECONVERSION, DO NOT REMOVE
"a" = (
/turf/open/floor/mineral/plastitanium,
/area/shuttle/supply)
"b" = (
/obj/machinery/conveyor{
	dir = 4;
	id = "maint_contraption"
	},
/obj/machinery/door/poddoor{
	id = "cargounload";
	name = "Supply Dock Unloading Door"
	},
/turf/open/floor/plating,
/area/shuttle/supply)
"e" = (
/obj/effect/turf_decal/tile/brown,
/obj/effect/turf_decal/tile/yellow{
	dir = 4
	},
/turf/open/floor/iron/dark/textured,
/area/shuttle/supply)
"h" = (
/obj/machinery/conveyor{
	dir = 8;
	id = "QMLoad"
	},
/obj/machinery/door/poddoor{
	id = "cargounload";
	name = "Supply Dock Unloading Door"
	},
/turf/open/floor/plating,
/area/shuttle/supply)
"o" = (
/obj/machinery/power/shuttle_engine/heater,
/obj/structure/window/reinforced/survival_pod/spawner/directional/west,
/obj/structure/window/reinforced/survival_pod/spawner/directional/east,
/obj/structure/window/reinforced/survival_pod/spawner/directional/north,
/turf/open/floor/plating/airless,
/area/shuttle/supply)
"p" = (
/obj/effect/turf_decal/tile/yellow{
	dir = 8
	},
/turf/open/floor/iron/dark/textured,
/area/shuttle/supply)
"q" = (
/obj/effect/turf_decal/tile/brown,
/obj/effect/turf_decal/tile/yellow{
	dir = 4
	},
/obj/machinery/button/door/directional/west{
	id = "QMLoaddoor";
	name = "Off Ramp Toggle";
	pixel_y = 8;
	req_access = list("cargo")
	},
/obj/machinery/button/door/directional/west{
	id = "QMLoaddoor2";
	name = "On Ramp Toggle";
	pixel_y = -8;
	req_access = list("cargo")
	},
/turf/open/floor/iron/dark/textured,
/area/shuttle/supply)
"r" = (
/obj/machinery/door/airlock/survival_pod/glass{
	name = "Supply Shuttle Airlock"
	},
/obj/effect/mapping_helpers/airlock/access/all/supply/general,
/turf/open/floor/plating,
/area/shuttle/supply)
"u" = (
/obj/structure/window/reinforced/survival_pod/spawner/directional/south,
/turf/open/floor/iron/dark/textured,
/area/shuttle/supply)
"v" = (
/obj/effect/turf_decal/tile/brown,
/turf/open/floor/iron/dark/textured,
/area/shuttle/supply)
"x" = (
/obj/effect/turf_decal/tile/yellow{
	dir = 8
	},
/obj/effect/turf_decal/tile/brown{
	dir = 1
	},
/obj/machinery/button/door/directional/east{
	id = "QMLoaddoor2";
	name = "Loading Doors";
	pixel_y = 8
	},
/obj/machinery/button/door/directional/east{
	id = "QMLoaddoor";
	name = "Loading Doors";
	pixel_y = -8
	},
/turf/open/floor/iron/dark/textured,
/area/shuttle/supply)
"y" = (
/turf/closed/wall/mineral/titanium/survival/nodiagonal,
/area/shuttle/supply)
"A" = (
/obj/effect/turf_decal/tile/yellow{
	dir = 4
	},
/obj/effect/turf_decal/tile/brown{
	dir = 1
	},
/turf/open/floor/iron/dark/textured,
/area/shuttle/supply)
"B" = (
/obj/effect/turf_decal/tile/brown{
	dir = 1
	},
/turf/open/floor/iron/dark/textured,
/area/shuttle/supply)
"C" = (
/turf/open/space/basic,
/area/template_noop)
"D" = (
/obj/effect/turf_decal/bot,
/turf/open/floor/iron/smooth,
/area/shuttle/supply)
"F" = (
/obj/machinery/power/shuttle_engine/heater,
/obj/structure/window/reinforced/survival_pod/spawner/directional/north,
/obj/structure/window/reinforced/survival_pod/spawner/directional/east,
/turf/open/floor/plating/airless,
/area/shuttle/supply)
"I" = (
/obj/effect/turf_decal/delivery,
/turf/open/floor/iron/smooth_large,
/area/shuttle/supply)
"K" = (
/obj/machinery/door/airlock/survival_pod/glass{
	name = "Supply Shuttle Airlock"
	},
/obj/effect/mapping_helpers/airlock/access/all/supply/general,
/obj/docking_port/mobile/supply{
	dir = 4
	},
/turf/open/floor/plating,
/area/shuttle/supply)
"N" = (
/obj/machinery/power/shuttle_engine/heater,
/obj/structure/window/reinforced/survival_pod/spawner/directional/west,
/obj/structure/window/reinforced/survival_pod/spawner/directional/north,
/turf/open/floor/plating/airless,
/area/shuttle/supply)
"P" = (
/obj/effect/spawner/structure/window/survival_pod,
/turf/open/floor/plating,
/area/shuttle/supply)
"R" = (
/obj/effect/turf_decal/tile/yellow{
	dir = 4
	},
/turf/open/floor/iron/dark/textured,
/area/shuttle/supply)
"S" = (
/obj/effect/turf_decal/tile/brown,
/obj/effect/turf_decal/tile/yellow{
	dir = 8
	},
/turf/open/floor/iron/dark/textured,
/area/shuttle/supply)
"U" = (
/obj/machinery/power/shuttle_engine/propulsion,
/turf/open/space/basic,
/area/shuttle/supply)
"V" = (
/obj/effect/turf_decal/tile/brown{
	dir = 1
	},
/obj/effect/turf_decal/tile/yellow{
	dir = 8
	},
/turf/open/floor/iron/dark/textured,
/area/shuttle/supply)
"Y" = (
/obj/machinery/power/shuttle_engine/heater,
/obj/structure/window/reinforced/survival_pod/spawner/directional/north,
/turf/open/floor/plating/airless,
/area/shuttle/supply)

(1,1,1) = {"
C
y
y
h
K
y
r
b
y
o
U
"}
(2,1,1) = {"
P
P
v
e
e
q
e
e
R
u
C
"}
(3,1,1) = {"
P
a
S
D
I
D
I
D
A
N
U
"}
(4,1,1) = {"
P
a
S
I
D
I
D
I
A
Y
U
"}
(5,1,1) = {"
P
a
S
D
I
D
I
D
A
F
U
"}
(6,1,1) = {"
P
P
p
V
V
x
V
V
B
u
C
"}
(7,1,1) = {"
C
y
y
b
r
y
r
h
y
o
U
"}
